Indie Pop Rocks! (alternative)|indiepop|New and classic favorite indie pop tracks.
Folk Forward (folkalternative)|folkfwd/|Indie Folk, Alt-folk and the occasional folk classics.
BAGeL Radio (alternative)|bagel|What alternative rock radio should sound like.
Digitalis (electronicaalternative)|digitalis/|Digitally affected analog rock to calm the agitated heart.
7soul (soul)|7soul|NEW! Vintage soul tracks from the original 45 RPM vinyl.
Groove Salad (ambientelectronica)|groovesalad/|A nicely chilled plate of ambient/downtempo beats and grooves.
Lush (electronica)|lush|Sensuous and mellow vocals, mostly female, with an electronic influence.
Space Station Soma (electronica)|spacestation|Tune in, turn on, space out. Spaced-out ambient and mid-tempo electronica.
Sonic Universe (jazz)|sonicuniverse|Transcending the world of jazz with eclectic, avant-garde takes on tradition.
Secret Agent (lounge)|secretagent|The soundtrack for your stylish, mysterious, dangerous life. For Spies and PIs too!
Suburbs of Goa (world)|suburbsofgoa|Desi-influenced Asian world beats and beyond.
Earwaves (experimental)|earwaves|Spanning the history of electronic and experimental music from the early pioneers to the latest innovators.
DEF CON Radio (specials)|events|Music for Hacking. Live from DEF CON 22 in Las Vegas.
The Trip (electronica)|thetrip|Progressive house / trance. Tip top tunes.
cliqhop idm (electronica)|cliqhop|Blips'n'beeps backed mostly w/beats. Intelligent Dance Music.
Dub Step Beyond (electronica)|dubstep|Dubstep, Dub and Deep Bass. May damage speakers at high volume.
Mission Control (ambientelectronica)|missioncontrol/|Celebrating NASA and Space Explorers everywhere.
Boot Liquor (americana)|bootliquor|Americana Roots music for Cowhands, Cowpokes and Cowtippers
Covers (eclectic)|covers|Just covers. Songs you know by artists you don't. We've got you covered.
Underground 80s (alternativeelectronica)|u80s/|Early 80s UK Synthpop and a bit of New Wave.
Illinois Street Lounge (lounge)|illstreet|Classic bachelor pad, playful exotica and vintage music of tomorrow.
Deep Space One (ambient)|deepspaceone|Deep ambient electronic, experimental and space music. A soundtrack for inner and outer space exploration.
Drone Zone (ambient)|dronezone|Served best chilled, safe with most medications. Atmospheric textures with minimal beats.
PopTron (alternative)|poptron|Electropop and indie dance rock with sparkle and pop.
Beat Blender (electronica)|beatblender|A late night blend of deep-house and downtempo chill.
Doomed (ambientindustrial)|doomed/|Dark industrial/ambient music for tortured souls.
Black Rock FM (eclectic)|brfm|From the Playa to the world, for the 2014 Burning Man festival.
SF 1|sf1033|Ambient music mixed with the sounds of San Francisco public safety radio traffic.
Iceland Airwaves (alternative)|airwaves|Music from bands who will be performing at Iceland Airwaves [explicit]
South by Soma (alternative)|sxfm|Music from bands who will be performing at SXSW, one of the biggest and best music festivals in the world. [explicit]
